bbbbbbbbbbbbbbbbbbbbbbbbbb
b........................b
b......c....c.......c....b
b........................b
b......f...........f..f..b
b..alaaaa..aaaaa..aaaaa..b
b...l....................b
b...l..c.....c........c..b
b...l........f.....f.....b
b..aaaaaa..aaaa..aaalaa..b
b...................l....b
b..c......c....c....l.c..b
b.........f.........l....b
b..aala..aaa..aaa..aaaa..b
b....l...................d
bbbbbbbbbbbbbbbbbbbbbbbbbb
