bbbbbbbbbbbbbbbbbbbbbbbbbb
b........................b
b........................b
b........................b
b........................b
b........................b
b........................b
b........................b
b........................b
b........................b
b........................b
b........................b
b...............mc.......b
b..............aaaa......b
b........................d
bbbbbbbbbbbbbbbbbbbbbbbbbb