bbbbbbbbbbbbbbbbbbbbbbbbbb
b........................b
b........................b
b........................b
b........................b
b........................b
b........................b
b........................b
b...........c............b
b.........oaaaa..........b
b.........o..............b
b.........O..............b
b......c..o..............b
b.....aaaaoaaaa..........b
b........................d
bbbbbbbbbbbbbbbbbbbbbbbbbb