bbbbbbbbbbbbbbbbbbbbbbbbbb
b........c.....c......c..b
b........................b
d......aaaaaa.....aaaaa..b
baalaa.......aaaa........b
b..l.....................b
b..l................mc...b
b..laa.ooOoo.aaaa..aaaa..b
b..y.....................b
b..l....c...........c....b
b..l...m.................b
b..aaaaaaa.oooOooo.aaal..b
b.....c......c.....c..l..b
b........c............y..b
b....f......f......f..l..b
bbbbbbbbbbbbbbbbbbbbbbbbbb
