bbbbbbbbbbbbbbbbbbbbbbbbbb
b........................b
b........................b
b........................b
b........................b
b........................b
b........................b
b........................b
b........................b
b........................b
b........................b
b........................b
b.......c........c.......b
b.....aaaaooOooaaaa......b
b........................d
bbbbbbbbbbbbbbbbbbbbbbbbbb