bbbbbbbbbbbbbbbbbbbbbbbbbb
b........................b
b......c....c.......c....b
b........................b
b......f....m......f..f..b
b..alaaaa..aaaaa..aaaaa..b
b...l....................b
b...l..c.....c........c..b
b...lm.......f.....f.....b
b..aaaaaa..aaaa..aaalaa..b
b...................l....b
b..c......c....c....l.c..b
b.........f.....m...l....b
b..aala..aaa..aaa..aaaa..b
b....l...................d
bbbbbbbbbbbbbbbbbbbbbbbbbb
