bbbbbbbbbbbbbbbbbbbbbbbbbb
b........................b
b........................b
b........................b
b........................b
b........................b
b........................b
b........................b
b........................b
b........................b
b........................b
b........................b
b......c.m........mc.....b
b.....aaaa.......aaaa....b
b........................d
bbbbbbbbbbbbbbbbbbbbbbbbbb