bbbbbbbbbbbbbbbbbbbbbbbbbb
b........................b
b........................b
b........................b
b........................b
b........................b
b........................b
b........................b
b........................b
b........................b
b........................b
b........................b
b..............m.c.......b
b.........aaa..aaaa......b
b........................d
bbbbbbbbbbbbbbbbbbbbbbbbbb