bbbbbbbbbbbbbbbbbbbbbbbbbb
b..c..c...c.......c......b
d........................b
b..aa.aa.aaaaooOooaal....b
b...................l....b
b..c................l.c..b
b....m....f...f....ml....b
b.aaaaa..aaalaaa..aaaaaa.b
b...........l...........cb
b....c....c.l........c...b
b.....m.....l.....c....aab
b.laaaaa..aaaa......aaa..b
b.l...............aa.....b
b.l.............aa.......b
b.l.....m....m...........d
bbbbbbbbbbbbbbbbbbbbbbbbbb
