bbbbbbbbbbbbbbbbbbbbbbbbbb
b........c.....c......c..b
b........................b
b....faaaaaaa....aaaaaa..b
b..laa........aaa........b
b..l.....................b
b..l...............m.c...b
b..laa.ooOoo.aaaa..aaa...b
b..y.....................b
b..l....c...........c....b
b..l...m........c........b
b..aaaaaaa.oooOooo.aaal..b
b.....c......c.....c..l..b
b........c............y..b
b....f......f......f..l..d
bbbbbbbbbbbbbbbbbbbbbbbbbb
