bbbbbbbbbbbbbbbbbbbbbbbbbb
b........................b
b........................b
b.c......................b
b.............c..c.f.....b
b.aaaa.ooooOooo.aaaaalaa.b
b............ .......l...b
b...c..............c.aa..b
b.aaal............laa....b
b....l............l......b
b....lc..c........l......d
b....aaaooooOoooooaaaa..ab
b..c.....................b
b.aaa....................b
b....ffffffffffffffffffffb
bbbbbbbbbbbbbbbbbbbbbbbbbb
