bbbbbbbbbbbbbbbbbbbbbbbbbb
b........................b
b........................b
b........................b
b........................b
b........................b
b........................b
b........................b
b........................b
b........................b
b........................b
b........................b
b......c.........c.......b
b.....aaaa.ooOo.oaaaa....b
b........................d
bbbbbbbbbbbbbbbbbbbbbbbbbb