bbbbbbbbbbbbbbbbbbbbbbbbbb
b........................b
b........................b
b........................b
b........................b
b........................b
b........................b
b........................b
b........................b
b........................b
b........................b
b........................b
b.........cm.....c.......b
b.........aaa..aaaa......b
b........................d
bbbbbbbbbbbbbbbbbbbbbbbbbb