bbbbbbbbbbbbbbbbbbbbbbbbbb
b........................b
b........................b
b........................b
b........................b
b........................b
b........................b
b........................b
b........................b
b........................b
b........................b
b........................b
b.........c.m....c.......b
b.........aaaa..aaa......b
b........................d
bbbbbbbbbbbbbbbbbbbbbbbbbb