bbbbbbbbbbbbbbbbbbbbbbbbbb
b........c.....c......c..b
b........................b
d......aaaaaa.....aaaaa..b
baalaa.......aaaa........b
b..l.....................b
b..l................mc...b
b..laa.......aaaao.aaaa..b
b........................b
b..l....c...........c....b
b..l...m.................b
b..aaaaaaaaaaaaaaaaaaal..b
b.....c......c.....c..l..b
b........................b
b....f......f......f..l..b
bbbbbbbbbbbbbbbbbbbbbbbbbb
