bbbbbbbbbbbbbbbbbbbbbbbbbb
b........................b
b........................b
b........................b
b........................b
b........................b
b........................b
b........................b
b........................b
b........................b
b........................b
b................c.......b
b..........c....m........b
b.........aaa..aaaa......b
b........................d
bbbbbbbbbbbbbbbbbbbbbbbbbb