bbbbbbbbbbbbbbbbbbbbbbbbbb
b........................b
b........................b
b........................b
b........................b
b........................b
b........................b
b........................b
b........................b
b........................b
b........................b
b........................b
b......c.........c.m.....b
b.....aaaa.......aaaa....b
b........................d
bbbbbbbbbbbbbbbbbbbbbbbbbb