bbbbbbbbbbbbbbbbbbbbbbbbbb
b........................b
b........................b
b........................b
b........................b
b........................b
b........................b
b........................b
b........................b
b........................b
b........................b
b........................b
b......c........mc.......b
b.....aaaaooOooaaaa......b
b........................d
bbbbbbbbbbbbbbbbbbbbbbbbbb