bbbbbbbbbbbbbbbbbbbbbbbbbb
b........................b
b........................b
b........................b
b........................b
b........................b
b........................b
b........................b
b........................b
b........................b
b........................b
b........................b
b..c.......c....c........b
b.aaa....aaaa..aaa.......b
b......f............f....d
bbbbbbbbbbbbbbbbbbbbbbbbbb