bbbbbbbbbbbbbbbbbbbbbbbbbb
b........................b
b........................b
b........................b
b........................b
b........................b
b........................b
b........................b
b........................b
b........................b
b........................b
b........................b
b......c...........c.....b
b.....aaaa.ooOoo.aaaa....b
b........................d
bbbbbbbbbbbbbbbbbbbbbbbbbb